enemyCount,col,row,boss,map,scene
1,3,3,,backgroundchurch,0
1,3,4,,,0
2,3,5,,,0
2,5,4,,,0
3,5,5,,,0
3,5,5,,,0
3,5,5,,,0
3,5,5,,,0
3,5,5,,,0
0,5,5,nun,,0
1,3,5,,backgroundblue,1
2,3,5,,,1
3,5,5,,,1
3,5,5,,,1
3,5,5,,,1
3,5,5,,,1
3,5,5,,,1
3,5,5,,,1
3,5,5,,,1
3,5,5,,,1
3,5,5,,,1
3,5,5,,,1
0,5,5,snowman,,1
1,3,5,,cave,2
2,3,5,,,2
3,5,5,,,2
3,5,5,,,2
3,5,5,,,2
3,5,5,,,2
3,5,5,,,2
3,5,5,,,2
3,5,5,,,2
3,5,5,,,2
3,5,5,,,2
3,5,5,,,2
3,5,5,,,2
3,5,5,,,2
2,5,5,horribleman,,2
